############
#  #   #  B#
##   #    ##
#  ######  #
#  #    ## #
# ## ##    #
#  # #  # ##
#  #  A #  #
##   ##### #
#    #   # #
#  #   #   #
############
